11111111111111111111111111111
00000000000000100000100000001
10111011111010101111101110101
10100010001010001000001010101
10101110101011101011111010111
10001000101010001010001010001
10111011101011111010101011101
10000010001000001010100010001
11101111101111101010111110111
10001000101000100010100010001
10111010101010111110101011101
10100010100010101000101000101
10101110111110101010101110101
10101000000010100010101010101
11101111111010101110101010101
10100010000010101000101010101
10111010111110111010101010101
10000010001000000010101000101
11111111101011111111101110101
10001000101010001000100010101
10101011101010101010111010101
10100010001010101010100010101
10111110111110101010101110101
10000000100000100010101010001
10111111111011111110101011101
10001000001000101000101010001
11101110101110101011101010111
10000000100000100000001000001
11111111111110111111111111111
