1111111111110111111111111
1100000100010001000000011
1101011101011101110101111
1101010001000100010100011
1101010111011111011101011
1101010101000001000101011
1111010101111101110111011
1100010000010100000100011
1101111111010111111101011
1100000001010000000001011
1101011101010111011111111
1101010101010001000000011
1101010101011111111111011
1101010001000100000100011
1101010111110101110101111
1101010001000100010100011
1101011111011111010111011
1101010001010001010100011
1101010101010101010101111
1101010100010100010100011
1101010111110111110111011
1101000100000100010000011
1101111111110101011111011
1100000000000101000000011
1111111111110111111111111