111111111111111
100000001000001
101110101010111
100010101010001
111110111011101
100000000010001
101010111010111
101010001010001
101011101011101
101000101010101
101110111010101
100010001000100
111011111111111