10111111111111111111111111111111111111111111111111
10000000000010001000000010100000100010000000000001
10111110111010101111111010101110101010111111101111
10000010100000100000000010001010001010001000100011
11111010111111111111111011111011111011101010111011
10000010100000001000001000100010001000100010001011
10111110101111101011101110101010101110111011111011
10100010001000101000100010101000100010100010001011
10101011111110101010111110111111101110101110101011
10101000001000101010000010000000100010101000100000
10111011101011101011111011111110111010111011111011
10000010000010001010000010001000000010001000001011
11111110111110111010111010101011111111101110101011
10100000100000100010100000101000100000100010101011
10101111101111101110111111101110101010111011101011
10101000100010001010001000101000101010001000001011
10101110111011101011101011101011101011111111111011
10101000001000100010101000001010001000000000001011
10101011101110111010101111111010111111111110101011
10100010001010001000100000001010001000001000101011
10111110111011101110111111101011101110101011111011
10100010000010100010001000001000100010101000000011
10101011111010111010111011111011111010101111111111
10001000000000001010100010000010000010100000001011
10111111111111101011101110111110111110101111101011
10100000000010001000100010100000100010101000001001
10101111111011111110101010101111101110101011111011
10101010000000001000101000100010001000101000001011
10101010111111101011101111111010101011101111101011
10101010100010000010001000000010100000101000100011
11101010101011111011111011111110111111101011111011
10001000101000100010001000100010101000001000100011
10111110101110101110101110101010101011111110101111
10000010100010101000101000101010001000000010001011
10111011111010111011101011101111101111111010111011
10101000100010000010100010100000100000100010000011
10101110101111111110111110101110111011101111111011
10000010100010000000000010101000001010001010001011
11111010111010111111111010101011111010111010101011
10100010001000100000001010001000000010100010100011
10101111101111101110101011101111111110111010111111
10100010000000101010101000101000001000100010000011
10111010111111101010111110101110101011101011111011
10100010000000001010100000100000101010001000100011
10101111111111111010101111111110111011101111101111
10100000001000001010101000100010100010001000100011
10111111101011101010101010101011101110111010111011
10000000000010000010000010001000001000000010000011
11111111111111111111111111111111111111111111111111