111111111111111111111111111111
100010000000001000001000000011
101110111110101011111011101011
101000100010100010000010101011
101011101010111010111110101111
100010001010100010100010100011
101110111010111110101010111011
100000100010000010101000100011
111011111011111010101111101111
100010001010001000101000100011
101110101010101111101010111011
101000101000101010001010001011
101011101111101010101011101011
101010000000101000101010101011
111011111110101011101010101011
001000100000101010001010101001
101110101111101110101010101011
100000100010000000101010001011
111111111010111111111011101011
100010001010100010001000101011
101010111010101010101110101011
101000100010101010101000101011
101111101111101010101011101011
100000001000001000101010100011
101111111110111111101010111011
100010000010001010001010100011
111011101011101010111010101111
100000001000001000000010000011
111111111111111111111111111111
111111111111111111111111111111